0000000000000000000000000000000000000000
0000000000000000000000000000000000000000
0000000000000000000000000000000000000000
0000000000000000000000000000000000000000
0000000000000000000000000000000000000000
0!!!!!!!!!00000000000000000000!!!!!!!!!0
0#########00000000000000000000#########0
0#0000000#00000000000000000000#0000000#0
0#0000000#00000000000000000000#0000000#0
0#0000000#@>0000000000000000<@#0000000#0
0#0000000#00000000000000000000#0000000#0
0#0000000#00000000000000000000#0000000#0
0#000000<#00000000000000000000#>000000#0
0#0000000#0000<@@@@@@@@@@>0000#0000000#0
0#000000000000000000000000000000000000#0
0#@>00000000000000000000000000000000<@#0
0#000000000000000000000000000000000000#0
0#000000000000000000000000000000000000#0
0#000000<@@@@@@@@@@@@@@@@@@@@@@>000000#0
0#000000000000000000000000000000000000#0
0#000000000000000000000000000000000000#0
0#000000000000000000000000000000000000#0
t#000000000000000000000000000000000000#t
1111111111100000000000000000111111111111
2222222222211000000000000011222222222222
2222222222222111111111111122222222222222