0000000000000000000000000000000000000000
0000000000000000000000000000000000000000
0000000000000000000000000000000000000000
00tttttttt0000000000000000000ttttttttt00
0031111114000000000000000000031111111400
0000000000000000000000000000000000000000
000000000000000ttttttttt0000000000000000
0000000000000003111111140000000000000000
0000000000000000000000000000000000000000
0000000000000000000000000000000000000000
0000000000000000000000000000000000000000
ttttt000000tttttt000000tttttt000000ttttt
3111400000031111400000031111400000031114
0000000000000000000000000000000000000000
0000000000000000000000000000000000000000
0000000000000000000000000000000000000000
00000tttttttttttttttttttttttttttttt00000
0000031111111111111111111111111111400000
0000000000000000000000000000000000000000
t000000000000000000000000000000000000000
1t00000000000000000000000000000000tttttt
21t0000000000ttttttttt00000000000t111111
221t000000ttt111111111ttt0000000t1222222
2221tttttt111222222222111ttttttt12222222
2222111111222222222222222111111122222222
2222222222222222222222222222222222222222
