0000000000000000000000000000000000000000
0000000000000000000000000000000000000000
0000000000000000000000000000000000000000
0000000000000000766666680000000000000000
0000000000000000000000000000000000000000
0000000000000000000000000000000000000000
0000000000000000000000000000000000000000
0000000000000000000000000000000000000000
0000000007666800000000000076668000000000
0000000000000000000000000000000000000000
0000000000000000000000000000000000000000
0000000000000000000000000000000000000000
0000000000000000000000000000000000000000
0076666800000005500000055000000076666800
0000000000000055000000005500000000000000
0000000000000550000000000550000000000000
0000000000005500000000000055000000000000
0000000000055000000000000005500000000000
0000000000550000000000000000550000000000
0000000005500000000000000000055000000000
0000000055000000000000000000005500000000
0000000550000000000000000000000550000000
0000005500000000000000000000000055000000
0000055000000000000000000000000005500000
0000550000000000000000000000000000550000
6666666666666666666666666666666666666666